background_exemplo.png
aaaaa.aaaaaaaaaaaaab..i.................
afP.........a..a.gab..i....s.s..........
a...ss.a..aa....a.ab..i.....sA..........
a..s.Bsa.a...Ba.a.ab..i.....s...........
ag..aa.a..aa.a.a.gab..i.....s...........
aa...a...B..a.a..aab..i....s.s..........
ad....Gd.a...GK...ab..i.................
a...oaaa.D..aaaaa.ab..i.................
ac..qr......E.........i.................
aaaaaaaaaaaaaaaaaaabaaaaaaaaaaaaaaaaaaaa

