Highlands1edit.png
aaaaa.aaaaaaaaaaaaab..i..............................................................
a..................b..i..............................................................
a..................b..i..............................................................
a..................b..i..............................................................
af..........a..a.gab..i....s.s.....4.................................................
a...ss.a..aa....a.ab..i.....sA....4v4................................................
a..s.Bsa.a...Ba.a.ab..i.....s....4vvv4...............................................
ag..aa.a..aa.a.a.gab..i.....s....vvvvv...............................................
aa...a...B..a.a..aab..i....s.s...4444444.............................................
ad....Gd.a...GK...ab..i..........wwwwwww.............................................
a...oaaa....aaaaa.ab..i..............................................................
acP.qr......E.........i12222222222222223.............................................
aaaaaaaaaaaaaaaaaaabaaaaaaaaaaaaaaaaaaaaaaaaaaaaaaaaaaaaaaaaaaaaaaaaaaaaaaaaaaaaaaaaa
