background_exemplo2.png
aaaaaaaaaaaaaaaaaaaaaaaaaaaaaa
a............................a
a............................a
a............................a
a............................a
a............................a
a............................a
a............................a
a.P..........................a
a.......a....................a
a.A....aaa....B.....C....E...a
aaaaaaaaaaaaaaaaaaaaaaaaaaaaaa
aaaaaaaaaaaaaaaaaaaaaaaaaaaaaa
